{
	"buildings": [
		{
			"type" : "House",
			"textures" : {
				"closed" : "A11Haus.png"
				"open" : "A1Haus.png"
			},
			"position" : [800, 250],
			"originalSize" : [64, 64], 
			"requestedSize" : [225, 225], 
			"map" : "InnenContracts.txt",
			"buildingData" : {}
		}
	], "npcs": [
		{
			"type" : "npc",
			"fps" : 7,
			"textures" : {
				"idle" : "FritzA.png"
			},
			"position" : [870, 870],
			"originalSize" : [64, 32], 
			"requestedSize" : [135, 75], 
			"npcData" : {
			
			}
		}
		
		{
			"type" : "npc",
			"fps" : 7,
			"textures" : {
				"idle" : "GandalfA.png"
			},
			"position" : [840, 430],
			"originalSize" : [32, 32], 
			"requestedSize" : [55, 65], 
			"npcData" : {
			
			}
		}
		
		{
			"type" : "demon",
			"dir" : "void",
			"fps" : 5,
			"textures" : {
				"idle" : "AndromedusIdle.png"
			},
			"position" : [600, 1600],
			"originalSize" : [64, 64], 
			"requestedSize" : [80, 80], 
			"npcData" : {
			
			}
		}
		
		{
			"type" : "demon",
			"dir" : "shadow",
			"fps" : 7,
			"textures" : {
				"idle" : "MelloAShadow.png"
			},
			"position" : [750, 1600],
			"originalSize" : [64, 64], 

			"requestedSize" : [100, 100], 


			"npcData" : {
			
			}
		}
		
	], "map": {
		"startingPosition" : [13, 37],
		"size" : [50, 50],
		"dir" : "tiles",
		"textures" : [
			"Stein.png",
			"LavaS3.png",
			"SandOG.png",
			"SGELO.png",
			"SGGSU.png",
			"SGMELO.png",
			"Sand.png",
			"GrasBoden.png",
			"SGEMRU.png",
			"Pflanze.png",
			"SandOGL.png",
			"SGGSR.png",
			"SGGMMERU.png",
			"SGGSL.png",
			"SGGSU.png",
			"SGELU.png",
			"SGGSOW.png",
			"SGGMMERO.png",
			"SandOGU.png",
			"Wasser.png",
			"SteinWandWasser.png",
			"SELU.png",
			"SteinWandWasserGerade.png",
			"SteinWandWasserEcke.png",
			"SteinWandWasserEckeC.png",
			"SteinWandWasserEckeR.png",
			"SteinWandWasserEckeF.png",
			"SteinWandWasserEckeRR.png",
			"GrasEcke.png",
			"SGGSO.png",
			"SteinWandWasserEckeRG.png",
			"SGERU.png",
			"GrasEckeLO.png",
			"GrasSas.png",
			"SteinWandWasserEckeRU.png",
			"SteinWandWasserEckeRRU.png",
			"SERUU.png",
			"SGERO.png",
			"GrasEckeLU.png",
			"SteinWandWasserEckeLU.png",
			"SteinWandWasserEckeLLU.png",
			"GrasEckeFF.png",
			"Hoffnung.png",
			"Hope2.png",
			"SteinWandWasserEckeLG.png",
			"Hope3.png",
			"Hope4.png",
			"Hope5.png",
			"Gras.png",
			"Hope6.png",
			"DGERU.png",
			"AWDAD.png",
			"GEGEGE.png",
			"DGERU2.png",
			"AWDAD2.png",
			"GEGEGE2.png",
			"DGERU3.png",
			"AWDAD3.png",
			"GEGEGE3.png",
			"DGERU4.png",
			"AWDAD4.png",
			"GEGEGE4.png",
			"Nanana.png",
			"Puff.png",
			"FFFF.png",
			"Zaun.png",
			"Zaun2.png",
			"ZaunS.png",
			"ZaunF.png",
			"ZaunFF.png",
			"ZaunSS.png",
			"DM.png",
			"DL.png",
			"Eingang.png",
			"HL.png",
			"DR.png",
			"HR.png",
			"HSL.png",
			"HSRU.png",
			"HSLU.png",
			"HSRO.png",
			"HSLO.png",
			"HSR.png",
			"Baum.png",
			"ALMU.png",
			"ALEU.png",
			"ALSML.png",
			"ALEO.png",
			"AMF.png",
			"ALSMO.png",
			"AREO.png",
			"ALSMR.png",
			"AREU.png",
			"SandOGR.png",
			"Hope7.png"
		],
		"matrix" : 
"19 19 19 19 19 19 19 19 19 19 19 19 19 19 19 19 19 19 19 19 19 19 19 19 19 19 19 19 19 19 19 19 19 19 19 19 19 19 19 19 19 19 19 19 19 19 19 19 19 19
19 19 19 19 19 19 19 19 19 19 19 19 19 19 19 19 19 19 19 19 19 19 19 19 19 19 19 19 19 19 19 19 19 19 19 19 19 19 19 19 19 19 19 19 19 19 19 19 19 19
19 19 19 19 19 19 19 19 19 19 19 19 19 19 19 19 19 19 19 19 19 19 19 19 19 19 19 19 19 19 19 19 19 19 19 19 19 19 19 19 19 19 19 19 19 19 19 19 19 19
19 19 19 19 19 19 19 19 19 19 19 19 19 19 19 19 19 19 19 19 19 19 19 19 19 19 19 19 19 19 19 19 19 19 19 19 19 19 19 19 19 19 19 19 19 19 19 19 19 19
19 19 19 19 19 19 19 19 19 19 19 19 19 19 19 19 19 19 19 19 19 19 19 19 19 19 19 19 19 19 19 19 19 19 19 19 19 19 19 19 19 19 19 19 19 19 19 19 19 19
19 19 19 19 19 19 19 19 19 19 19 19 19 26 30 30 30 30 30 30 30 30 30 30 39 19 19 19 19 19 19 19 19 19 19 19 19 19 19 19 19 19 19 19 19 19 19 19 19 19
19 19 19 19 19 19 19 19 19 19 19 19 26 27 9 48 7 7 9 9 48 48 48 7 40 39 19 19 19 19 19 19 19 19 19 19 19 19 19 19 19 19 19 19 19 19 19 19 19 19
19 19 19 19 19 19 19 19 19 19 19 19 25 7 48 7 9 9 7 48 48 7 7 48 9 44 19 19 19 19 19 19 19 19 19 19 19 19 19 19 19 19 19 19 19 19 19 19 19 19
19 19 19 19 19 19 19 19 19 19 19 19 25 48 48 9 7 9 9 7 48 7 48 48 7 44 19 19 19 19 19 19 19 19 19 19 19 19 19 19 19 19 19 19 19 19 19 19 19 19
19 19 19 19 19 19 19 19 19 19 19 19 25 7 48 7 48 48 7 48 48 7 7 48 7 44 19 19 19 19 19 19 19 19 19 19 19 19 19 19 19 19 19 19 19 19 19 19 19 19
19 19 19 19 19 19 19 19 19 19 19 19 25 7 48 7 48 9 7 48 7 48 48 7 48 44 19 19 19 19 19 19 19 19 19 19 19 19 19 19 19 19 19 19 19 19 19 19 19 19
19 19 19 19 19 19 19 19 19 19 19 19 25 7 48 9 9 48 48 7 7 9 9 48 9 40 39 19 19 19 19 19 19 19 19 19 19 19 19 19 19 19 19 19 19 19 19 19 19 19
19 19 19 19 19 19 19 19 19 19 19 19 25 9 7 9 7 48 7 9 9 48 48 7 9 9 40 30 30 30 30 30 30 30 30 30 30 39 19 19 19 19 19 19 19 19 19 19 19 19
19 19 19 19 19 19 19 19 19 19 19 19 25 9 7 48 48 48 7 9 7 7 9 48 9 7 9 7 7 48 9 48 9 9 48 9 7 40 39 19 19 19 19 19 19 19 19 19 19 19
19 19 19 19 19 19 19 19 19 19 19 19 25 48 7 48 7 7 48 48 9 9 48 7 7 48 7 48 7 9 48 7 7 48 7 48 7 7 44 19 19 19 19 19 19 19 19 19 19 19
19 19 19 19 19 19 19 19 19 19 19 19 23 24 9 7 7 48 48 9 9 9 7 48 48 7 7 9 7 9 7 48 48 7 7 48 9 7 44 19 19 19 19 19 19 19 19 19 19 19
19 19 19 19 19 19 19 19 19 19 19 19 19 23 22 22 22 22 22 24 7 7 9 48 7 9 48 7 7 48 9 9 7 7 48 7 48 9 40 39 19 19 19 19 19 19 19 19 19 19 19
19 19 19 19 19 19 19 19 19 19 19 19 19 19 19 19 19 19 19 25 7 9 48 7 7 7 7 9 48 7 48 7 9 7 7 9 7 7 9 44 19 19 19 19 19 19 19 19 19 19
19 19 19 19 19 19 19 19 19 19 19 19 19 19 19 19 19 19 19 25 48 7 48 48 7 9 48 9 7 48 9 48 7 48 9 7 48 9 7 44 19 19 19 19 19 19 19 19 19 19
19 19 19 19 19 19 19 19 19 19 19 19 19 19 19 19 19 19 19 25 7 48 7 48 48 7 48 7 7 7 48 7 48 7 48 7 48 48 9 44 19 19 19 19 19 19 19 19 19 19
19 19 19 19 19 19 19 19 19 19 19 19 19 19 19 19 19 19 19 25 7 48 7 9 7 48 7 48 48 9 9 48 7 48 7 48 9 9 7 44 19 19 19 19 19 19 19 19 19 19
19 19 19 19 19 19 19 19 19 19 19 19 19 19 19 19 19 19 19 25 7 48 9 7 12 4 4 4 38 7 48 7 9 48 7 48 9 7 9 44 19 19 19 19 19 19 19 19 19 19
19 19 19 19 19 19 19 19 19 19 19 19 19 19 19 19 19 19 19 25 48 7 7 9 11 46 2 47 13 48 9 48 7 48 7 9 48 7 7 44 19 19 19 19 19 19 19 19 19 19
19 19 19 19 19 19 19 19 19 19 19 19 19 19 19 19 19 19 19 25 7 9 7 9 11 10 6 93 13 48 7 7 48 7 48 7 48 7 48 44 19 19 19 19 19 19 19 19 19 19
19 19 19 19 19 19 19 19 19 19 19 19 19 19 19 19 19 19 19 25 7 9 48 7 11 49 18 43 13 7 9 48 7 9 48 48 7 48 9 44 19 19 19 19 19 19 19 19 19 19
19 19 19 19 19 19 19 19 19 19 19 19 19 19 19 19 19 19 19 25 48 7 7 48 28 29 29 29 9 48 7 48 48 7 48 48 9 7 7 44 19 19 19 19 19 19 19 19 19 19
19 19 19 19 19 19 19 19 19 19 19 19 19 19 19 19 19 19 19 25 9 7 48 7 48 9 7 48 7 9 48 48 7 9 7 7 9 7 9 44 19 19 19 19 19 19 19 19 19 19
19 19 19 19 19 19 19 19 19 19 19 19 19 19 19 19 19 19 19 25 7 7 9 7 48 7 48 7 48 7 48 7 9 7 48 48 48 48 7 44 19 19 19 19 19 19 19 19 19 19
19 19 19 19 19 19 19 19 19 19 19 19 19 19 19 19 19 19 19 23 24 9 48 7 7 48 9 7 7 48 9 7 48 9 7 9 7 48 9 44 19 19 19 19 19 19 19 19 19 19
19 19 19 19 19 19 19 19 19 19 19 19 19 19 19 19 19 19 19 19 23 24 12 4 4 4 38 48 9 7 7 48 48 48 7 7 48 9 35 34 19 19 19 19 19 19 19 19 19 19
19 19 19 19 19 19 19 19 19 19 19 19 19 19 19 19 19 19 19 19 19 25 11 46 2 47 13 35 22 22 22 22 22 22 22 22 22 22 34 19 19 19 19 19 19 19 19 19 19 19
19 19 19 19 19 19 19 19 19 19 19 19 19 19 19 19 19 19 19 19 19 25 11 10 6 45 13 44 19 19 19 19 19 19 19 19 19 19 19 19 19 19 19 19 19 19 19 19 19 19
19 19 19 19 19 19 19 19 19 19 26 30 30 30 30 30 30 30 39 19 19 25 11 10 6 45 13 44 19 19 19 19 19 19 19 19 19 19 19 19 19 19 19 19 19 19 19 19 19 19
19 19 19 19 19 19 19 19 19 26 27 9 8 4 4 4 38 7 40 39 19 25 11 10 6 45 13 44 19 19 19 19 19 19 19 19 19 19 19 19 19 19 19 19 19 19 19 19 19 19
19 19 19 19 19 19 19 19 19 25 7 8 3 2 2 2 37 41 9 40 30 27 11 10 6 45 13 44 19 19 19 19 19 19 19 19 19 19 19 19 19 19 19 19 19 19 19 19 19 19
19 19 19 19 19 19 19 19 19 25 12 3 5 6 6 6 6 37 4 4 4 4 42 6 6 45 13 44 19 19 19 19 19 19 19 19 19 19 19 19 19 19 19 19 19 19 19 19 19 19
19 19 19 19 19 19 19 19 19 25 11 10 6 6 6 6 6 6 2 2 2 2 6 6 6 45 13 44 19 19 19 19 19 19 19 19 19 19 19 19 19 19 19 19 19 19 19 19 19 19
19 19 19 19 19 19 19 19 19 25 11 10 6 6 6 6 6 6 6 6 6 6 6 6 6 45 13 44 19 19 19 19 19 19 19 19 19 19 19 19 19 19 19 19 19 19 19 19 19 19
19 19 19 19 19 19 19 19 19 25 11 10 6 6 6 6 6 6 18 18 18 18 18 18 18 43 13 44 19 19 19 19 19 19 19 19 19 19 19 19 19 19 19 19 19 19 19 19 19 19
19 19 19 19 19 19 19 19 19 25 17 15 6 6 6 6 6 31 29 29 29 29 29 29 29 29 32 44 19 19 19 19 19 19 19 19 19 19 19 19 19 19 19 19 19 19 19 19 19 19 
19 19 19 19 19 19 19 19 19 25 9 17 15 18 18 18 31 33 7 35 22 22 22 22 22 22 22 34 19 19 19 19 19 19 19 19 19 19 19 19 19 19 19 19 19 19 19 19 19 19
19 19 19 19 19 19 19 19 19 23 24 7 28 29 29 29 32 9 35 34 19 19 19 19 19 19 19 19 19 19 19 19 19 19 19 19 19 19 19 19 19 19 19 19 19 19 19 19 19 19
19 19 19 19 19 19 19 19 19 19 23 22 22 22 22 22 22 22 34 19 19 19 19 19 19 19 19 19 19 19 19 19 19 19 19 19 19 19 19 19 19 19 19 19 19 19 19 19 19 19
19 19 19 19 19 19 19 19 19 19 19 19 19 19 19 19 19 19 19 19 19 19 19 19 19 19 19 19 19 19 19 19 19 19 19 19 19 19 19 19 19 19 19 19 19 19 19 19 19 19
19 19 19 19 19 19 19 19 19 19 19 19 19 19 19 19 19 19 19 19 19 19 19 19 19 19 19 19 19 19 19 19 19 19 19 19 19 19 19 19 19 19 19 19 19 19 19 19 19 19
19 19 19 19 19 19 19 19 19 19 19 19 19 19 19 19 19 19 19 19 19 19 19 19 19 19 19 19 19 19 19 19 19 19 19 19 19 19 19 19 19 19 19 19 19 19 19 19 19 19
19 19 19 19 19 19 19 19 19 19 19 19 19 19 19 19 19 19 19 19 19 19 19 19 19 19 19 19 19 19 19 19 19 19 19 19 19 19 19 19 19 19 19 19 19 19 19 19 19 19
19 19 19 19 19 19 19 19 19 19 19 19 19 19 19 19 19 19 19 19 19 19 19 19 19 19 19 19 19 19 19 19 19 19 19 19 19 19 19 19 19 19 19 19 19 19 19 19 19 19
19 1 19 19 19 19 19 19 19 19 19 19 19 19 19 19 19 19 19 19 19 19 19 19 19 19 19 19 19 19 19 19 19 19 19 19 19 19 19 19 19 19 19 19 19 19 19 19 19 19
19 19 19 19 19 19 19 19 19 19 19 19 19 19 19 19 19 19 19 19 19 19 19 19 19 19 19 19 19 19 19 19 19 19 19 19 19 19 19 19 19 19 19 19 19 19 19 19 19 19"
	}
}